"a" = (/turf/space,/area/space)
"b" = (/turf/simulated/wall,/area/shelltooth/level_five)
"c" = (/turf/simulated/floor/tiled,/area/shelltooth/level_five)
"d" = (/obj/effect/floor_decal/industrial/warning/corner,/obj/structure/catwalk,/turf/simulated/floor,/area/shelltooth/level_five)
"e" = (/obj/structure/railing/mapped,/obj/effect/floor_decal/industrial/warning,/obj/structure/catwalk,/turf/simulated/floor,/area/shelltooth/level_five)
"f" = (/obj/effect/floor_decal/industrial/warning/corner{icon_state = "stripecorner"; dir = 8},/obj/structure/catwalk,/turf/simulated/floor,/area/shelltooth/level_five)
"g" = (/obj/structure/railing/mapped{icon_state = "railing0-1"; dir = 4},/obj/effect/floor_decal/industrial/warning{icon_state = "stripe"; dir = 4},/obj/structure/catwalk,/turf/simulated/floor,/area/shelltooth/level_five)
"h" = (/turf/simulated/open,/area/shelltooth/level_five)
"i" = (/obj/structure/railing/mapped{icon_state = "railing0-1"; dir = 8},/obj/effect/floor_decal/industrial/warning{icon_state = "stripe"; dir = 8},/obj/structure/catwalk,/turf/simulated/floor,/area/shelltooth/level_five)
"j" = (/obj/effect/floor_decal/industrial/warning{icon_state = "stripe"; dir = 8},/obj/structure/catwalk,/turf/simulated/floor,/area/shelltooth/level_five)
"k" = (/obj/effect/floor_decal/industrial/warning{icon_state = "stripe"; dir = 4},/obj/structure/catwalk,/turf/simulated/floor,/area/shelltooth/level_five)
"l" = (/obj/structure/railing/mapped{icon_state = "railing0-1"; dir = 1},/obj/structure/ladder/updown,/turf/simulated/open,/area/shelltooth/level_five)
"m" = (/obj/structure/lattice,/obj/structure/railing/mapped{icon_state = "railing0-1"; dir = 1},/turf/simulated/open,/area/shelltooth/level_five)
"n" = (/obj/structure/railing/mapped{icon_state = "railing0-1"; dir = 1},/obj/structure/lattice,/obj/structure/cable{icon_state = "2-4"},/obj/machinery/atmospherics/pipe/simple/hidden/scrubbers{icon_state = "intact-scrubbers"; dir = 6},/obj/machinery/atmospherics/pipe/simple/hidden/supply{icon_state = "intact-supply"; dir = 6; pixel_y = 0},/turf/simulated/open,/area/shelltooth/level_five)
"o" = (/obj/structure/railing/mapped{icon_state = "railing0-1"; dir = 1},/obj/structure/lattice,/turf/simulated/open,/area/shelltooth/level_five)
"p" = (/obj/effect/floor_decal/industrial/warning/corner{icon_state = "stripecorner"; dir = 1},/obj/effect/floor_decal/industrial/warning{icon_state = "stripe"; dir = 8},/obj/structure/catwalk,/turf/simulated/floor,/area/shelltooth/level_five)
"q" = (/obj/effect/floor_decal/industrial/warning/corner{icon_state = "stripecorner"; dir = 4},/obj/structure/catwalk,/turf/simulated/floor,/area/shelltooth/level_five)
"r" = (/obj/effect/floor_decal/industrial/warning{icon_state = "stripe"; dir = 1},/obj/structure/catwalk,/turf/simulated/floor,/area/shelltooth/level_five)
"s" = (/obj/machinery/light{icon_state = "tube_map"; dir = 1},/turf/simulated/floor/tiled,/area/shelltooth/level_five)
"t" = (/obj/effect/floor_decal/industrial/warning{icon_state = "stripe"; dir = 1},/obj/structure/cable{icon_state = "4-8"},/obj/structure/catwalk,/turf/simulated/floor,/area/shelltooth/level_five)
"u" = (/obj/effect/floor_decal/industrial/warning/corner{icon_state = "stripecorner"; dir = 1},/obj/structure/cable{d2 = 8; icon_state = "0-8"},/obj/machinery/power/apc/high{icon_state = "apc0"; dir = 4},/obj/structure/catwalk,/turf/simulated/floor,/area/shelltooth/level_five)
"v" = (/obj/structure/railing/mapped{icon_state = "railing0-1"; dir = 1},/obj/structure/lattice,/obj/machinery/atmospherics/pipe/zpipe/down/scrubbers{icon_state = "down-scrubbers"; dir = 8},/obj/machinery/atmospherics/pipe/zpipe/down/supply{icon_state = "down-supply"; dir = 8},/obj/structure/cable{icon_state = "32-8"},/turf/simulated/open,/area/shelltooth/level_five)
"w" = (/obj/effect/landmark/map_data{height = 5},/turf/space,/area/space)
"x" = (/obj/effect/landmark/test/space_turf,/turf/space,/area/space)
"y" = (/obj/effect/landmark/test/safe_turf,/turf/simulated/floor/tiled,/area/shelltooth/level_five)
"z" = (/obj/machinery/door/airlock/command,/turf/simulated/floor/tiled,/area/shelltooth/level_five)
"A" = (/obj/machinery/light,/turf/simulated/floor/tiled,/area/shelltooth/level_five)
"B" = (/obj/structure/railing/mapped,/obj/effect/floor_decal/industrial/warning,/obj/structure/catwalk,/obj/machinery/light{icon_state = "tube_map"; dir = 1},/turf/simulated/floor,/area/shelltooth/level_five)
"C" = (/obj/machinery/light{icon_state = "tube_map"; dir = 8},/turf/simulated/floor/tiled,/area/shelltooth/level_five)
"D" = (/obj/machinery/light{icon_state = "tube_map"; dir = 4},/turf/simulated/floor/tiled,/area/shelltooth/level_five)
"E" = (/obj/effect/floor_decal/industrial/warning{icon_state = "stripe"; dir = 1},/obj/machinery/atmospherics/pipe/cap/hidden/scrubbers{icon_state = "cap-scrubbers"; dir = 1},/obj/machinery/atmospherics/pipe/cap/hidden/supply{icon_state = "cap-supply"; dir = 1},/obj/structure/cable{d1 = 1; d2 = 4; icon_state = "1-4"},/obj/structure/catwalk,/obj/machinery/light,/turf/simulated/floor,/area/shelltooth/level_five)

(1,1,1) = {"
aaaaaaaaaaaaaaaaaaaaaaaaaaaaaaaaaaaaaaaaaaaaaaaaaaaaaaaaaaaaaaaa
awaaaaaaaaaaaaaaaaaaaaaaaaaaaaaaaaaaaaaaaaaaaaaaaaaaaaaaaaaaaaaa
aaaaaaaaaaaaaaaaaaaaaaaaaaaaaaaaaaaaaaaaaaaaaaaaaaaaaaaaaaaaaaaa
aaaaaaaaaaaaaaaaaaaaaaaaaaaaaaaaaaaaaaaaaaaaaaaaaaaaaaaaaaaaaaaa
aaaaaaaaaaaaaaaaaaaaaaaaaaaaaaaaaaaaaaaaaaaaaaaaaaaaaaaaaaaaaaaa
aaaaaaaaaaaaaaaaaaaaaaaaaaaaaaaaaaaaaaaaaaaaaaaaaaaaaaaaaaaaaaaa
aaaaaaaaaaaaaaaaaaaaaaaaaaaaaaaaaaaaaaaaaaaaaaaaaaaaaaaaaaaaaaaa
aaaaaaaaaaaaaaaaaaaaaaaaaaaaaaaaaaaaaaaaaaaaaaaaaaaaaaaaaaaaaaaa
aaaaaaaaaaaaaaaaaaaaaaaaaaaaaaaaaaaaaaaaaaaaaaaaaaaaaaaaaaaaaaaa
aaaaaaaaaaaaaaaaaaaaaaaaaaaaaaaaaaaaaaaaaaaaaaaaaaaaaaaaaaaaaaaa
aaaaaaaaaaaaaaaaaaaaaaaaaaaaaaaaaaaaaaaaaaaaaaaaaaaaaaaaaaaaaaaa
aaaaaaaaaaaaaaaaaaaaaaaaaaaaaaaaaaaaaaaaaaaaaaaaaaaaaaaaaaaaaaaa
aaaaaaaaaaaaaaaaaaaaaaaaaaaaaaaaaaaaaaaaaaaaaaaaaaaaaaaaaaaaaaaa
aaaaaaaaaaaaaaaaaaaaaaaaaaaaaaaaaaaaaaaaaaaaaaaaaaaaaaaaaaaaaaaa
aaaaaaaaaaaaaaaaaaaaaaaaaaaaaaaaaaaaaaaaaaaaaaaaaaaaaaaaaaaaaaaa
aaaaaaaaaaaaaaaaaaaaaaaaaaaaaaaaaaaaaaaaaaaaaaaaaaaaaaaaaaaaaaaa
aaaaaaaaaaaaaaaaaaaaaaaaaaaaaaaaaaaaaaaaaaaaaaaaaaaaaaaaaaaaaaaa
aaaaaaaaaaaaaaaaaaaaaaaaaaaaaaaaaaaaaaaaaaaaaaaaaaaaaaaaaaaaaaaa
aaaaaaaaaaaaaaaaaaaaaaaaaaaaaaaaaaaaaaaaaaaaaaaaaaaaaaaaaaaaaaaa
aaaaaaaaaaaaaaaaaaaaaaaaaaaaaaaxaaaaaaaaaaaaaaaaaaaaaaaaaaaaaaaa
aaaaaaaaaaaaaaaaaaaaaaaaaaaaaaaaaaaaaaaaaaaaaaaaaaaaaaaaaaaaaaaa
aaaaaaaaaaaaaaaaaaaaaaaaaaaaaaaaaaaaaaaaaaaaaaaaaaaaaaaaaaaaaaaa
aaaaaaaaaaaaaaaaaaaaaaaabbbbaaaaaaaaaaaaaaaaaaaaaaaaaaaaaaaaaaaa
aaaaaaaaaaaaaaaaaaaaaaaabccbbbbbbbbbaaaaaaaaaaaaaaaaaaaaaaaaaaaa
aaaaaaaaaaaaaaaaaaaaaaaabccbcccscccbbbbaaaaaaaaaaaaaaaaaaaaaaaaa
aaaaaaaaaaaaaaaaaaaaaaaabcczcccyccczccbaaaaaaaaaaaaaaaaaaaaaaaaa
aaaaaaaaaaaaaaaaaaaaaaabbcczccccccczccbbaaaaaaaaaaaaaaaaaaaaaaaa
aaaaaaaaaaaaaaaaaaaaaaabcccbcccAcccbcccbaaaaaaaaaaaaaaaaaaaaaaaa
aaaaaaaaaaaaaaaaaaaaaabbcccbbbbbbbbbcccbbaaaaaaaaaaaaaaaaaaaaaaa
aaaaaaaaaaaaaaaaaaaaaabccccbdeeBeefbccccbaaaaaaaaaaaaaaaaaaaaaaa
aaaaaaaaaaaaaaaaaaaaaabccccbghhhhhibccccbaaaaaaaaaaaaaaaaaaaaaaa
aaaaaaaaaaaaaaaaaaaaaabccccbghhhhhjcccccbaaaaaaaaaaaaaaaaaaaaaaa
aaaaaaaaaaaaaaaaaaaaaabCcccbghhhhhjccccDbaaaaaaaaaaaaaaaaaaaaaaa
aaaaaaaaaaaaaaaaaaaaaabccccbghhhhhjcccccbaaaaaaaaaaaaaaaaaaaaaaa
aaaaaaaaaaaaaaaaaaaaaabccccbghhhhhibccccbaaaaaaaaaaaaaaaaaaaaaaa
aaaaaaaaaaaaaaaaaaaaaabccccbklmnvopbccccbaaaaaaaaaaaaaaaaaaaaaaa
aaaaaaaaaaaaaaaaaaaaaabbbzzbqrrEttubbbbbbaaaaaaaaaaaaaaaaaaaaaaa
aaaaaaaaaaaaaaaaaaaaaaabcccbbbbbbbbbcccbaaaaaaaaaaaaaaaaaaaaaaaa
aaaaaaaaaaaaaaaaaaaaaaabcccccccscccccccbaaaaaaaaaaaaaaaaaaaaaaaa
aaaaaaaaaaaaaaaaaaaaaaabccAcccccccccAccbaaaaaaaaaaaaaaaaaaaaaaaa
aaaaaaaaaaaaaaaaaaaaaaabbbbcccccccccbbbbaaaaaaaaaaaaaaaaaaaaaaaa
aaaaaaaaaaaaaaaaaaaaaaaaaabcccccccccbaaaaaaaaaaaaaaaaaaaaaaaaaaa
aaaaaaaaaaaaaaaaaaaaaaaaaabbcccAcccbbaaaaaaaaaaaaaaaaaaaaaaaaaaa
aaaaaaaaaaaaaaaaaaaaaaaaaaabbbbbbbbbaaaaaaaaaaaaaaaaaaaaaaaaaaaa
aaaaaaaaaaaaaaaaaaaaaaaaaaaaaaaaaaaaaaaaaaaaaaaaaaaaaaaaaaaaaaaa
aaaaaaaaaaaaaaaaaaaaaaaaaaaaaaaaaaaaaaaaaaaaaaaaaaaaaaaaaaaaaaaa
aaaaaaaaaaaaaaaaaaaaaaaaaaaaaaaaaaaaaaaaaaaaaaaaaaaaaaaaaaaaaaaa
aaaaaaaaaaaaaaaaaaaaaaaaaaaaaaaaaaaaaaaaaaaaaaaaaaaaaaaaaaaaaaaa
aaaaaaaaaaaaaaaaaaaaaaaaaaaaaaaaaaaaaaaaaaaaaaaaaaaaaaaaaaaaaaaa
aaaaaaaaaaaaaaaaaaaaaaaaaaaaaaaaaaaaaaaaaaaaaaaaaaaaaaaaaaaaaaaa
aaaaaaaaaaaaaaaaaaaaaaaaaaaaaaaaaaaaaaaaaaaaaaaaaaaaaaaaaaaaaaaa
aaaaaaaaaaaaaaaaaaaaaaaaaaaaaaaaaaaaaaaaaaaaaaaaaaaaaaaaaaaaaaaa
aaaaaaaaaaaaaaaaaaaaaaaaaaaaaaaaaaaaaaaaaaaaaaaaaaaaaaaaaaaaaaaa
aaaaaaaaaaaaaaaaaaaaaaaaaaaaaaaaaaaaaaaaaaaaaaaaaaaaaaaaaaaaaaaa
aaaaaaaaaaaaaaaaaaaaaaaaaaaaaaaaaaaaaaaaaaaaaaaaaaaaaaaaaaaaaaaa
aaaaaaaaaaaaaaaaaaaaaaaaaaaaaaaaaaaaaaaaaaaaaaaaaaaaaaaaaaaaaaaa
aaaaaaaaaaaaaaaaaaaaaaaaaaaaaaaaaaaaaaaaaaaaaaaaaaaaaaaaaaaaaaaa
aaaaaaaaaaaaaaaaaaaaaaaaaaaaaaaaaaaaaaaaaaaaaaaaaaaaaaaaaaaaaaaa
aaaaaaaaaaaaaaaaaaaaaaaaaaaaaaaaaaaaaaaaaaaaaaaaaaaaaaaaaaaaaaaa
aaaaaaaaaaaaaaaaaaaaaaaaaaaaaaaaaaaaaaaaaaaaaaaaaaaaaaaaaaaaaaaa
aaaaaaaaaaaaaaaaaaaaaaaaaaaaaaaaaaaaaaaaaaaaaaaaaaaaaaaaaaaaaaaa
aaaaaaaaaaaaaaaaaaaaaaaaaaaaaaaaaaaaaaaaaaaaaaaaaaaaaaaaaaaaaaaa
aaaaaaaaaaaaaaaaaaaaaaaaaaaaaaaaaaaaaaaaaaaaaaaaaaaaaaaaaaaaaaaa
aaaaaaaaaaaaaaaaaaaaaaaaaaaaaaaaaaaaaaaaaaaaaaaaaaaaaaaaaaaaaaaa
"}
