"a" = (/turf/space,/area/space)
"b" = (/turf/simulated/floor/reinforced/airless,/area/shelltooth/level_four)
"c" = (/turf/simulated/wall,/area/shelltooth/level_four)
"d" = (/turf/simulated/floor/tiled,/area/shelltooth/level_four)
"e" = (/turf/simulated/floor/reinforced/airless,/area/space)
"f" = (/obj/effect/floor_decal/industrial/warning/corner,/obj/structure/catwalk,/turf/simulated/floor,/area/shelltooth/level_four)
"g" = (/obj/structure/railing/mapped,/obj/effect/floor_decal/industrial/warning,/obj/structure/catwalk,/turf/simulated/floor,/area/shelltooth/level_four)
"h" = (/obj/effect/floor_decal/industrial/warning/corner{icon_state = "stripecorner"; dir = 8},/obj/structure/catwalk,/turf/simulated/floor,/area/shelltooth/level_four)
"i" = (/obj/structure/railing/mapped{icon_state = "railing0-1"; dir = 4},/obj/effect/floor_decal/industrial/warning{icon_state = "stripe"; dir = 4},/obj/structure/catwalk,/turf/simulated/floor,/area/shelltooth/level_four)
"j" = (/turf/simulated/open,/area/shelltooth/level_four)
"k" = (/obj/structure/railing/mapped{icon_state = "railing0-1"; dir = 8},/obj/effect/floor_decal/industrial/warning{icon_state = "stripe"; dir = 8},/obj/structure/catwalk,/turf/simulated/floor,/area/shelltooth/level_four)
"l" = (/obj/effect/floor_decal/industrial/warning{icon_state = "stripe"; dir = 8},/obj/structure/catwalk,/turf/simulated/floor,/area/shelltooth/level_four)
"m" = (/obj/effect/floor_decal/industrial/warning{icon_state = "stripe"; dir = 4},/obj/structure/catwalk,/turf/simulated/floor,/area/shelltooth/level_four)
"n" = (/obj/structure/railing/mapped{icon_state = "railing0-1"; dir = 1},/obj/structure/ladder/updown,/turf/simulated/open,/area/shelltooth/level_four)
"o" = (/obj/structure/lattice,/obj/structure/railing/mapped{icon_state = "railing0-1"; dir = 1},/obj/structure/cable{icon_state = "32-4"},/obj/machinery/atmospherics/pipe/zpipe/down/supply{icon_state = "down-supply"; dir = 4},/obj/machinery/atmospherics/pipe/zpipe/down/scrubbers{icon_state = "down-scrubbers"; dir = 4},/turf/simulated/open,/area/shelltooth/level_four)
"p" = (/obj/structure/railing/mapped{icon_state = "railing0-1"; dir = 1},/obj/structure/lattice,/obj/machinery/atmospherics/pipe/manifold/hidden/scrubbers{icon_state = "map-scrubbers"; dir = 1},/obj/machinery/atmospherics/pipe/manifold/hidden/supply{dir = 1},/obj/structure/cable{d1 = 2; d2 = 8; icon_state = "2-8"},/obj/structure/cable{icon_state = "4-8"},/turf/simulated/open,/area/shelltooth/level_four)
"q" = (/obj/structure/railing/mapped{icon_state = "railing0-1"; dir = 1},/obj/structure/lattice,/obj/machinery/atmospherics/pipe/zpipe/up/scrubbers{icon_state = "up-scrubbers"; dir = 8},/obj/machinery/atmospherics/pipe/zpipe/up/supply{icon_state = "up-supply"; dir = 8},/obj/structure/cable{icon_state = "16-0"},/obj/structure/cable{icon_state = "0-8"},/turf/simulated/open,/area/shelltooth/level_four)
"r" = (/obj/structure/railing/mapped{icon_state = "railing0-1"; dir = 1},/obj/structure/lattice,/turf/simulated/open,/area/shelltooth/level_four)
"s" = (/obj/effect/floor_decal/industrial/warning/corner{icon_state = "stripecorner"; dir = 1},/obj/effect/floor_decal/industrial/warning{icon_state = "stripe"; dir = 8},/obj/structure/catwalk,/turf/simulated/floor,/area/shelltooth/level_four)
"t" = (/obj/effect/floor_decal/industrial/warning/corner{icon_state = "stripecorner"; dir = 4},/obj/structure/catwalk,/turf/simulated/floor,/area/shelltooth/level_four)
"u" = (/obj/effect/floor_decal/industrial/warning{icon_state = "stripe"; dir = 1},/obj/structure/catwalk,/turf/simulated/floor,/area/shelltooth/level_four)
"v" = (/obj/effect/floor_decal/industrial/warning{icon_state = "stripe"; dir = 1},/obj/machinery/atmospherics/pipe/cap/hidden/scrubbers{icon_state = "cap-scrubbers"; dir = 1},/obj/machinery/atmospherics/pipe/cap/hidden/supply{icon_state = "cap-supply"; dir = 1},/obj/structure/cable{icon_state = "1-4"},/obj/structure/catwalk,/obj/machinery/light,/turf/simulated/floor,/area/shelltooth/level_four)
"w" = (/obj/effect/floor_decal/industrial/warning{icon_state = "stripe"; dir = 1},/obj/structure/cable{icon_state = "4-8"},/obj/structure/catwalk,/turf/simulated/floor,/area/shelltooth/level_four)
"x" = (/obj/effect/floor_decal/industrial/warning/corner{icon_state = "stripecorner"; dir = 1},/obj/structure/cable{icon_state = "0-8"},/obj/machinery/power/apc/high{icon_state = "apc0"; dir = 4},/obj/structure/catwalk,/turf/simulated/floor,/area/shelltooth/level_four)
"y" = (/obj/machinery/light{icon_state = "tube_map"; dir = 1},/turf/simulated/floor/tiled,/area/shelltooth/level_four)
"z" = (/obj/machinery/light{icon_state = "tube_map"; dir = 8},/turf/simulated/floor/tiled,/area/shelltooth/level_four)
"A" = (/obj/machinery/light{icon_state = "tube_map"; dir = 4},/turf/simulated/floor/tiled,/area/shelltooth/level_four)
"B" = (/obj/machinery/light,/turf/simulated/floor/tiled,/area/shelltooth/level_four)
"C" = (/obj/structure/railing/mapped,/obj/effect/floor_decal/industrial/warning,/obj/structure/catwalk,/obj/machinery/light{icon_state = "tube_map"; dir = 1},/turf/simulated/floor,/area/shelltooth/level_four)

(1,1,1) = {"
aaaaaaaaaaaaaaaaaaaaaaaaaaaaaaaaaaaaaaaaaaaaaaaaaaaaaaaaaaaaaaaa
aaaaaaaaaaaaaaaaaaaaaaaaaaaaaaaaaaaaaaaaaaaaaaaaaaaaaaaaaaaaaaaa
aaaaaaaaaaaaaaaaaaaaaaaaaaaaaaaaaaaaaaaaaaaaaaaaaaaaaaaaaaaaaaaa
aaaaaaaaaaaaaaaaaaaaaaaaaaaaaaaaaaaaaaaaaaaaaaaaaaaaaaaaaaaaaaaa
aaaaaaaaaaaaaaaaaaaaaaaaaaaaaaaaaaaaaaaaaaaaaaaaaaaaaaaaaaaaaaaa
aaaaaaaaaaaaaaaaaaaaaaaaaaaaaaaaaaaaaaaaaaaaaaaaaaaaaaaaaaaaaaaa
aaaaaaaaaaaaaaaaaaaaaaaaaaaaaaaaaaaaaaaaaaaaaaaaaaaaaaaaaaaaaaaa
aaaaaaaaaaaaaaaaaaaaaaaaaaaaaaaaaaaaaaaaaaaaaaaaaaaaaaaaaaaaaaaa
aaaaaaaaaaaaaaaaaaaaaaaaabbbbaaaaaaaaaaaaaaaaaaaaaaaaaaaaaaaaaaa
aaaaaaaaaaaaaaaaaaaaaaaaabbbbaaaaaaaaaaaaaaaaaaaaaaaaaaaaaaaaaaa
aaaaaaaaaaaaaaaaaaaaaaaaabbbbaaaaaaaaaaaaaaaaaaaaaaaaaaaaaaaaaaa
aaaaaaaaaaaaaaaaaaaaaaaaabbbbaaaaaaaaaaaaaaaaaaaaaaaaaaaaaaaaaaa
aaaaaaaaaaaaaaaaaaaaaaaaabbbbaaaaaaaaaaaaaaaaaaaaaaaaaaaaaaaaaaa
aaaaaaaaaaaaaaaaaaaaaaaaabbbbaaaaaaaaaaaaaaaaaaaaaaaaaaaaaaaaaaa
aaaaaaaaaaaaaaaaaaaaaaaaabbbbaaaaaaaaaaaaaaaaaaaaaaaaaaaaaaaaaaa
aaaaaaaaaaaaaaaaaaaaaaaaabbbbaaaaaaaaaaaaaaaaaaaaaaaaaaaaaaaaaaa
aaaaaaaaaaaaaaaaaaaaabbbbbbbbaaaaaaaaabbbbaaaaaaaaaaaaaaaaaaaaaa
aaaaaaaaaaaaaaaaaaaaabbbbbbbbaaaaaaaaabbbbaaaaaaaaaaaaaaaaaaaaaa
aaaaaaaaaaaaaaaaaaabbbbbbbbbbbbbbbbbbbbbbbbbaaaaaaaaaaaaaaaaaaaa
aaaaaaaaaaaaaaaaaaabbbbbbbbbbbbbbbbbbbbbbbbbaaaaaaaaaaaaaaaaaaaa
aaaaaaaaaaaaaaaaaaabbbbbbbbbbbbbbbbbbbbbbbbbaaaaaaaaaaaaaaaaaaaa
aaaaaaaaaaaaaaaaaaabbbbbbbbbbbbbbbbbbbbbbbbbaaaaaaaaaaaaaaaaaaaa
aaaaaaaaaaaaaaaaaaabbbbbbbbbbbbbbbbbbbbbbbbbaaaaaaaaaaaaaaaaaaaa
aaaaaaaaaaaaaaaaaaabbbbbbbbbbbbbbbbbbbbbbbbbaaaaaaaaaaaaaaaaaaaa
aaaaaaaaaaaaaaabbbbbbbbbbbbbbbbbbbbbbbbbbbbbbbbbaaaaaaaaaaaaaaaa
aaaaaaaaaaaaaaabbbbbbbbbcccccccccccccccbbbbbbbbbaaaaaaaaaaaaaaaa
aaaaaaaaaaaaaaabbbbbbbbbcddddddyddddddcbbbbbbbbbaaaaaaaaaaaaaaaa
aaaaaaaaaaaaaaabbbbbbbbbcdddddddddddddcbbbbbbbbbaaaaaaaaaaaaaaaa
aaaaaaaaaaaaaaabbbbbbbbbcddcccccccccddcbbbbbbbbbaaaaaaaaaaaaaaaa
aaaaaaaaaaaaaaabbbbbbbbbcddcfggCgghcddcbbbbbbbbbaaaaaaaaaaaaaaaa
aaaaaaaaaaaaaaaaebbbbbbbcddcijjjjjkcddcbbbbbbbaaaaaaaaaaaaaaaaaa
aaaaaaaaaaaaaaaaabbbbbbbcddcijjjjjldddcbbbbbbbaaaaaaaaaaaaaaaaaa
aaaaaaaaaaaaaaaaabbbbbbbczdcijjjjjlddAcbbbbbbbaaaaaaaaaaaaaaaaaa
aaaaaaaaaaaaaaaaabbbbbbbcddcijjjjjldddcbbbbbbbaaaaaaaaaaaaaaaaaa
aaaaaaaaaaaaaaaaabbbbbbbcddcijjjjjkcddcbbbbbbbaaaaaaaaaaaaaaaaaa
aaaaaaaaaaaaaaabbbbbbbbbcddcmnopqrscddcbbbbbbbbbaaaaaaaaaaaaaaaa
aaaaaaaaaaaaaaabbbbbbbbbcddctuuvwwxcddcbbbbbbbbbaaaaaaaaaaaaaaaa
aaaaaaaaaaaaaaabbbbbbbbbcddcccccccccddcbbbbbbbbbaaaaaaaaaaaaaaaa
aaaaaaaaaaaaaaabbbbbbbbbcdddddddddddddcbbbbbbbbbaaaaaaaaaaaaaaaa
aaaaaaaaaaaaaaabbbbbbbbbcddddddBddddddcbbbbbbbbbaaaaaaaaaaaaaaaa
aaaaaaaaaaaaaaabbbbbbbbbcccccccccccccccbbbbbbbbbaaaaaaaaaaaaaaaa
aaaaaaaaaaaaaaaaaaabbbbbbbbbbbbbbbbbbbbbbbbbaaaaaaaaaaaaaaaaaaaa
aaaaaaaaaaaaaaaaaaabbbbbbbbbbbbbbbbbbbbbbbbbaaaaaaaaaaaaaaaaaaaa
aaaaaaaaaaaaaaaaaaabbbbbbbbbbbbbbbbbbbbbbbbbaaaaaaaaaaaaaaaaaaaa
aaaaaaaaaaaaaaaaaaabbbbbbbbbbbbbbbbbbbbbbbbbaaaaaaaaaaaaaaaaaaaa
aaaaaaaaaaaaaaaaaaabbbbbbbbbbbbbbbbbbbbbbbbbaaaaaaaaaaaaaaaaaaaa
aaaaaaaaaaaaaaaaaaabbbbbbbbbbbbbbbbbbbbbbbbbaaaaaaaaaaaaaaaaaaaa
aaaaaaaaaaaaaaaaaaaaabbbbbbbbbbbbbbbbabbbbaaaaaaaaaaaaaaaaaaaaaa
aaaaaaaaaaaaaaaaaaaaabbbbbbbbaaaaaaaaabbbbaaaaaaaaaaaaaaaaaaaaaa
aaaaaaaaaaaaaaaaaaaaaaaaabbbbaaaaaaaaaaaaaaaaaaaaaaaaaaaaaaaaaaa
aaaaaaaaaaaaaaaaaaaaaaaaabbbbaaaaaaaaaaaaaaaaaaaaaaaaaaaaaaaaaaa
aaaaaaaaaaaaaaaaaaaaaaaaabbbbaaaaaaaaaaaaaaaaaaaaaaaaaaaaaaaaaaa
aaaaaaaaaaaaaaaaaaaaaaaaabbbbaaaaaaaaaaaaaaaaaaaaaaaaaaaaaaaaaaa
aaaaaaaaaaaaaaaaaaaaaaaaabbbbaaaaaaaaaaaaaaaaaaaaaaaaaaaaaaaaaaa
aaaaaaaaaaaaaaaaaaaaaaaaabbbbaaaaaaaaaaaaaaaaaaaaaaaaaaaaaaaaaaa
aaaaaaaaaaaaaaaaaaaaaaaaabbbbaaaaaaaaaaaaaaaaaaaaaaaaaaaaaaaaaaa
aaaaaaaaaaaaaaaaaaaaaaaaaaaaaaaaaaaaaaaaaaaaaaaaaaaaaaaaaaaaaaaa
aaaaaaaaaaaaaaaaaaaaaaaaaaaaaaaaaaaaaaaaaaaaaaaaaaaaaaaaaaaaaaaa
aaaaaaaaaaaaaaaaaaaaaaaaaaaaaaaaaaaaaaaaaaaaaaaaaaaaaaaaaaaaaaaa
aaaaaaaaaaaaaaaaaaaaaaaaaaaaaaaaaaaaaaaaaaaaaaaaaaaaaaaaaaaaaaaa
aaaaaaaaaaaaaaaaaaaaaaaaaaaaaaaaaaaaaaaaaaaaaaaaaaaaaaaaaaaaaaaa
aaaaaaaaaaaaaaaaaaaaaaaaaaaaaaaaaaaaaaaaaaaaaaaaaaaaaaaaaaaaaaaa
aaaaaaaaaaaaaaaaaaaaaaaaaaaaaaaaaaaaaaaaaaaaaaaaaaaaaaaaaaaaaaaa
aaaaaaaaaaaaaaaaaaaaaaaaaaaaaaaaaaaaaaaaaaaaaaaaaaaaaaaaaaaaaaaa
"}
